XXXXXXXXXXXXXXXXXXXXXXXXXXXXXXXXXXXXXXXXXXX
X                   www                   X
X                                         X
X     RR                            RR    X
X           X                  X          X
XXXXXXXXXXXXX                  XXXXXXXXXXXX
X                                         X
X                                         X
X                                         X
X             X     RRR    X              X
X             XXXXXXXXXXXXXX              X
