XXXXXXXXXXXXXXXXXXXXXXXXXXXXXXXXXXXXXXXX
X                  ww                  X
X                  RR                  X
X            XXXXXXXXXXXXXX            X
X                                      X
X    R                           R     X
X                                      X
XXXXXXXXXXXXXXXX        XXXXXXXXXXXXXXXX
X                                      X
X                                      X
X                                   R  X
X                               X   R  X
X                               X      X
X               XXXXXXXXXX      XXXXXXXX
X     R         XXXXXXXXXX      XXXXXXXX
